11111111111111111111111111111
1P001000000000000000000000CC1
100010000011100111111111100C1
10001000011100011111111110001
100010001110000000000CC110001
1000100111000000000000C110001
100010111C0000011111111110001
10001111CCC000111111111100001
10001111111110011C00000000001
10001111111110011CC0000000001
10001000000110011111111110001
10001000000110011111111110001
1C001000000000000000000000001
1CC000000000000000000000000E1
11111111111111111111111111111
