11111111111111111
1111C000000000001
111PCCC0001111101
1111C0000011000E1
11111111111111111