1111111111111111111
1E00000000000000001
1010010100100001101
1010010010100001101
1P000000000000000C1
1111111111111111111