1111111111111111111
1000000CP00000E0001
1111111111111111111