1111111111111111111
1CCCCCCCCCCCCCCCCC1
1111111C111C1111111
111111CCC1111111111
1CCCCCPECCCC1111111
1CCCCCCCCCCCCCCCCC1
11111111111C1111111
1CCCCCCCCCCCCCCCCC1
1111111111111111111