1111111111111111111
1111111111111111111
1111111111111111111
1111111111111111111
11111111CPE11111111
1111111111111111111
1111111111111111111
1111111111111111111
1111111111111111111
1111111111111111111