1111111111111111111
1P00000000000000001
10000001C0011110001
1000001C00000010001
100001C000001100001
10001CCCC0010000001
10001111C0010000001
10000001C0011110001
10000000000000000E1
1111111111111111111