11111111111
1E100000C01
10100001101
10101111101
1P0CCCC00C1
11111111111