1111111111111111111
1000000101011111111
1010000101010001111
10100E00CCCCCCCCCC1
1111000000110000001
1111000000000010001
11110000001000P0001
1000000000100000001
1111111111111111111