1111111111111111111
1000000100011111111
1010000100010001111
10100E0011000C00001
1111000000010000001
10000000000100000P1
1111111111111111111