1111111111
111CCC0001
1111110001
1P00000E11
1111111111
