111111111
10000E001
100000001
100000001
100000001
100PC0001
111111111