1111111111111111111
1000000100011111111
10100001CC010001111
1E10000011000000001
1111000000010000001
1000C000000100000P1
1111111111111111111