111111111111
100000010001
10100001CC01
1E1000011101
111100000001
100PC0000001
111111111111