1111111111111111111
1CCCCCCCCCCCCCCCCC1
1111111011101111111
1111110001111111111
100000PEC0001111111
1CCCCCCCCCCCCCCCCC1
1111111111101111111
1CCCCCCCCCCCCCCCCC1
1111111111111111111